#          M
# ######### 
# #       # 
# # ##### # 
#   #     # 
### # ##### 
I   #       